疒	ab
丁	ad	[dīng]
㇆ 乛⺄㇗乚ヿㄋㄅ	ae
丰 龶	af
缶 	af	[fǒu]
鬼	ag
乙	ai
六	al
耒	al	[lěi]
门	am
皿	am	[mǐn]
片 爿丬	ap
舌 	as
未	aw
弓	bg
乂 㐅	bi	[yì]
彐 彑	bj	[jì]
 	bk
卵	bl
卯 	bm
面	bm
女	bn
氏	bs
聿 肀	bv	[yù]
云 	by
不	cb
虫 	cc
飞	cf
古	cg
火 灬	ch
支	ci
及	cj
尸 	cs
业	cy
口 〇	dk
里	dl
民	dm
黾	dm	[mǐn]
无 旡	du
由	dy
干	eg
见	ej
木 朩	em
欠	eq
彡 	es	[shān]
𠂉	et
穴 	ex	[xué]
也	ey
㡀	fb	[bì]
辰	fc
骨 冎	fg
一 ㇀	fi
且	fq
示 礻	fs
亡 亾	fw
歹 歺	gd	[dǎi]
高 	gg
句	gj
丨 亅	gs
士	gs
土	gt
韦	gw
羊 ⺷⺶芈	gy
八 丷䒑癶	hb
夫	hf
谷 	hg
子	hi
夂 夊	hi	[zhǐ]
攵 攴	hp	[pū]
壴 	hu	[zhù]
心 忄⺗	hx
册 	ic
丶 ㇏	id
艮 	ig	[gěn]
丩	ij	[jiū]
立 	il
舟	io
糸 纟	is	[sī]
予	iv	[yǔ]
乡	ix
幺	iy	[yāo]
斗	jd
亼 亽	ji	[jí]
仑 侖	jl
人 亻	jr
豕 	js	[shǐ]
入	ju
寸	kc
亥	kh
㠯	ki	[yǐ]
九	kj
母	km
水 氵⺍氺	ks
厶 龴	ks	[sī]
毋 毌	ku	[wú]
艹 廾丌艸	lc
齿	lc
而	le
方	lf
廿 龷	ln	[niàn]
千	lq
生	ls
卅 	ls	[sà]
夕	lx
卌	lx	[xì]
牙	ly
巴	mb
大	md
二	me
光 	mg
户 	mh
豸	mi	[zhì]
冂 凵⺆	mk
两	ml
犬 犭	mq
石	ms
甫	nf
鬲	ng	[gé]
黄	nh
勹	nk
匚 コ	nk
马	nm
十 𠂇	ns
戊 戉	nu	[wù]
王	nw
辛	nx
贝	ob
川 巛巜	oc
自	oi
几 ⺇	oj
日 曰⺜	or
矢	os	[shǐ]
尤 尢	oy
长 镸	pc
刀 〢刂リ	pd
儿 	pe
戈 	pg	[gē]
黑 	ph
弋	pi	[yì]
臼 	pj	[jiù]
米 	pm
鼠 	ps
足 ⻊	pu
行	px
走	pz
臣 	qc
耳	qe
井 	qj
老 耂	ql
目 	qm
牛 牜⺧	qn
齐	qq
食 饣	qs
田	qt
非	rf
之	ri
巾	rj
囗(框)	rk
了	rl
皮	rp
七 	rq
殳	rs	[shū]
竹 ⺮	ru
瓦	rw
又 ス	ry
屮 	sc	[cǎo]
各	sg
止 龰	si
甲	sj
力	sl
尚 龸	ss
言 讠	sy
阝	te
弗 𢎨𠂔	tf	[fú]
革	tg	[gé]
衣 衤	ti
斤 	tj
龙	tl
丿 ㇒	tp
疋 𤴓⺪	ts	[shū]
三	ts
雨 ⻗	tv
用 	ty
白	ub
辶	uc	[chuò]
工	ug
隹	ui	[zhuī]
手 扌龵	us
廴	uy	[yǐn]
匕 	vb	[bǐ]
已	vi	[yǐ]
己 	vj	[jǐ]
㐄 	vk	[kuà]
毛	vm
乃 	vn
气	vq
禸 ⽱	vr	[róu]
山	vs
巳	vs	[sì]
文	vw
西 覀	vx
月 ⺝	vy
乍	wa	[zhà]
冫 ⺀	wb	[bīng]
彳 亍	wc	[chì chù]
宀 冖	wg
龟	wg
兔 	wt
五	wu
鱼 𩵋	wv
象	wx
页 頁	wy
厂 ⺁	xc
⺈ 	xd
广	xg
禾 	xh
鹿	xl
鸟 	xn
束	xs
乌	xu
音	xy
爪 爫	ya
卜 ⺊	yb	[bǔ]
车 車	yc
瓜	yg
至	yi
曲	yq
四 罒	ys
小 ⺌𡭔	yx
酉	yy	[yǒu]
豆	zd
甘 	zg
虎 虍	zh
金 钅	zj
卩 ㄗ⺋	zj	[jié]
可 	zk
麻	zm
身 㐆	zs
亠	zt
羽	zv
习	zx